R 1920 1080 
NO ./textures/grey.xpm
SO ./textures/grey.xpm
WE ./textures/grey.xpm
EA ./textures/grey.xpm
S ./textures/grey2.xpm
F 100,100,20
C 100,150,100

       
1111111111111111111111111111111111111111
1000000002000001000000000000000000000001
10000000000001000000000000000000000W0001
1111111111111111111111111111111111111111
