R 1920 1080
NO ./textures/grey2.xpm
SO ./textures/grey2.xpm
WE ./textures/grey2.xpm
EA ./textures/grey2.xpm
S ./textures/barrel.xpm
F 100,100,20
C 100,150,100


       11111
1111111000001111111111111111111111111111111111
1222222222222222222222001112122111111111111
120000000S000000000000000001 10000021111111 1      111
1222222222222222222222222221112222111111111111     101
111111111111111111111111111111111111111111111111   111
 
111
101
111