R 1920 1080
NO ./textures/wn.xpm
SO ./textures/ws.xpm
WE ./textures/ww.xpm
EA ./textures/we.xpm
S ./textures/barrel.xpm
F 117,106,104
C 162,202,228


       11111
1111111000001111111111111111111111111111111111
1222222222222222222222001112122111111111111
1200000000000000000000000001 10000021111111 1      111
1222222222222222222222222221112222111111111111     101
111111111111111111111111111111111111111111111111   111

1
111
1S1
111
