R 1920 1080 
NO ./textures/grey2.xpm
SO ./textures/grey2.xpm
WE ./textures/grey2.xpm
EA ./textures/grey2.xpm
S ./textures/grey2.xpm
F 100,100,20
C 100,150,100

       11111
1111111000001111111111111111111111111111111111
100000000111000001100000000000000000001  1  111
1000000001S1000000100000000000000000001  1  101
111111111111111111111111111111111111111111111111 
111
101
111