R 1920 1080
NO ./textures/wn.xpm
SO ./textures/ws.xpm
WE ./textures/ww.xpm
EA ./textures/we.xpm
S ./textures/barrel.xpm
F 117,106,104
C 162,202,228

1111111111111111111111111111111111111111
1000010001100111001000010100111010000001
1011001101011000101101101100110000110001
1001200101010011100010010100111001000011
1011010101100000001100000000110000000011
1121111011000001001010111001011100000001
1000100010000100110101010000101000000011
1101010000000111001001201000010000100001
1010000002001010001110010000000101000001
1011000010110001000000100010011001000001
1100011011000010100100000010111000000111
1101101002110100000000001001010010010111
1000010101111000001021111100000001100101
1000001000010010010000001010002001010001
1100111000011000010001101101011001001101
1011010000010001011000101100010101110011
1000120111001010101110000111011100100001
1001001010000110011000000010000200000001
1100001000100110101000100001111010101001
1000110000010201011001000001011010010011
1011001000100012110010010010001110000001
1000100000110000011011000210111111010001
1000010000011010110010101010000010001011
1000000101110002011001000000000000000101
1001100011011000101010011000021001011001
1000101100201110000101000010000210000111
1111011010210010000010000000002010000001
1011111000000011110111110010100100100101
1100000001010110001000000011001100001111
1010000111000001010100111011100001011011
1001010000011001111100001100101001011011
1110001000101000010011001112110000101001
1110100110001111010210000010001111011111
100100111010101100000011010N011101100011
1011001000111102000101000000010000000001
1111020010000011120100002111000111111101
1101100000000010000111001000110010010011
1011001100100000100012110110100011100011
1100101101110111000010021101001000100111
1111111111111111111111111111111111111111