R 1920 1080
NO ./textures/grey2.xpm
SO ./textures/grey2.xpm
WE ./textures/grey2.xpm
EA ./textures/grey2.xpm
S ./textures/barrel.xpm
F 100,100,20
C 100,150,100

       1
1111111111
100S000001
1000000001
1002200001
1000000001
1000000001
1000000001
1000000001
1000000001
1000200001
1000000001
1000200001
1000000001
1000000001
1000000001
1000000001
1000000001
1000000001
1000000001
1000000001
1000000001
1000000001
1000000001
1000000001
1000000001
1000000001
1000000001
1000000001
1000000001
1000000001
1000000001
1000000001
1000000001
1000000001
1000000001
1000000001
1000000001
1000000001
1000200001
1011111011
