C 162,202,228


SO ./textures/ws.xpm
NO ./textures/ww.xpm
EA ./textures/we.xpm


WE /home/cvarela-/sgoinfre/cursus/cub_entrega1/textures/wn.xpm
S ./textures/barrel.xpm

F 117,106,104


111  111 11111111  1111111  11111111111
101  101 10000001  1000001  10000000021
101  101 10111101  1000001  11111011111
10111101 101  101  1111101      101
100S0001 10111101      101      101
10111101110000001111111101111111101111111
101  100000111100000000000000000000000021
111  1111111  111111111111111111111111111
