C 162,202,228


SO ./textures/ws.xpm
NO ./textures/ww.xpm
EA ./textures/we.xpm


WE ./textures/wn.xpm
S ./textures/barrel.xpm

F 117,106,104


11      1
1011111111
1000020001
100S002001
1000000001
1020000201
1000000001
1000000001
1020000201
1000000001
1000000001
1000000001
1002200001
1000100001
 111111111
 
1111
1011 
1111
