C 162,202,228


SO ./textures/ws.xpm
NO ./textures/ww.xpm
EA ./textures/we.xpm


WE ./textures/wn.xpm
S ./textures/barrel.xpm

F 117,106,104


1111111111111111
1000000S00000001
1000000000000001
1000000000000001
1202000002000021
1000000000000001
1200000000000021
1000000000200001
1000020000000021
1000000000000001
1200000020000021
1000000000000001
100111111111001
1001       101
1111       111
